9 9
S..###..#
..#....##
#.#...###
.....####
#....##.#
#..#.##.#
#.##.###.
#....####
####....E